GPSSPGGGGGGGGGGGGGGGGGGGGGGGGGGGGGGGGGGGGGGGGGGGGGGGGGGPSSPG
PPSSPPPPPPPPPPPPPPPPPPPPPPPPPPPPPPPPPPPPPPPPPPPPPPPPPPPPSSPP
SSSSSSSSSSSSSSSSSSSSSSSSSSSSZSSZSSSSSSSSSSSSSSSSSSSSSSSSSSSS
SSSSSSSSSSSSSSSSSSSSSSSSSSSSZSSZSSSSSSSSSSSSSSSSSSSSSSSSSSSS
GPSSPPPZZPPPPPPPPPPPPPPPPPPPPSSPPPPPPPPPPPPPPPPPPPPZZPPPSSPP
GPSSPGPSSPGBBGBBGGBBGGBBGBBGPSSPGBBGBBGGBBGGBBGBBGPSSPBPSSPG
GPSSPBPSSPPPPPPPPPPPPPPPPPPPPSSPPPPPPPPPPPPPPPPPPPPSSPBPSSPG
GPSSPBPSSSSSSSSZSSZSSSSSSSSSSSSSSSSSSSSSSSSSSSSSSSSSSPGPSSPG
GPSSPBPSSSSSSSSZSSZSSSSSSSSSSSSSSSSSSSSSSSSSSSSSSSSSSPBPSSPG
GPSSPBPSSPPPPPPPSSPPPPPPPPPPPPPPPPPPPPPPPPPPPPPPPPPSSPBPSSPG
GPSSPGPSSSPPGBBPSSPGGGGGBBBBBGPPPPPPPPGGBBBBBBGBBPSSSPGPSSPG
GPSSPBPSSSSPPGBPSSPGTGPPPPPPPPPSSSSSSPPPBBBBBBGBBPSGSPBPSSPG
GPSSPBPPSSSSPPGPSSPGGGPSSSSSSSSSSSSSSSSPPPGGGPPPPPSGSPBPSSPG
GPSSPGGPPSSSSPPPSSPPBBPSSSSSSSSSSPPSSSSSSPPPGPSSSSSGSPGPSSPG
GPSSPGGGPPSSSSPSSSSPPPPSSPSSPPSSPPPPPSSSSSSPPPSSSSSSSPGPSSPG
GPSSPGGGGPPSSSSSBBSSSSSSSSSSPPSSSSSSPPPSSSSSSZSSPPPPPPGPSSPG
GPSSPGGGGGPPSSSSBBSSSSSSSSSSPPSPPPPSSSPPPSSSSZSSPPSSPGGPSSPG
GPSSPGGGGGGPPPPSSSSPPPPPPPPPPPSPPSSSSSSPPPPPPPSSPPSSPTTPSSPG
GPSSPGGGGGGGGGPPSSPPSSSSSSSSGPSSSSPPSSSSPPGTGPSSSSSSPTGPSSPG
GPSSPGGGGGGBBBGPSSSSSSSSSSSSSPPPPPPPPSSSSPPGPPSSSSSSPTTPSSPG
GPSSPGGGGGGBBBGPSSSSSSPPPPSSSSSSSSSSPPSSSSPPPSSSPPPPPTTPSSPG
GPSSPGGGGGGBBBGPSSPPPPPGGPPSSSSSSSSSSPPSSSSPSSSSPBBBBTGPSSPG
GPSSPGPPPPPPPPPPSSPGGGGGGGPPPPPPPPSSSSPPSSSSSSSPPBBBBBGPSSPG
GPSSPGPSSSSSSSSSSSPGGGGGGGGGGGBBGPPSSSSPPSSSSSPPGGGGGGGPSSPG
GPSSPGPSSSSSSSSSSSPGGGGBGGGGGGBBGGPPSSSSPPPPSSSPPPPPPGTPSSPG
GPSSPGPSSPPPPPPPSSPGGGGGGGGGGGGGGGGPPSSSSSSPSSSSSSSSPGTPSSPG
GPSSPGPSSPBGBBBPSSPGGGGGGGGGGPPPPGGGPPSSSSSPPSSSSSSSPGTPSSPG
GPSSPGPSSPBGBBBPSSPGGGGGGGGGPPSSPPGGGPPPPPPPPPPPPPZZPPGPSSPG
GPZZPPPZZPPPPPPPSSPPPPPPPPPPPSSSSPPPPPPPPPPPPPPPPSSSSPPPZZPG
GPSSSSSSSSSSSSSSSSSSSSSSSSSSSSBBSSSSSSSSSSSSSSSSSSBBSSSSSSPG
GPSSSSSSSSSSSSSSSSSSSSSSSSSSSSBBSSSSSSSSSSSSSSSSSSBBSSSSSSPG
GPZZPPPPPPPPPPPPPPPPSSPPPPPPPSSSSPPPPPPPSSPPPPPPPSSSSPPPZZPG
GPSSPGPSSSSPPBBBBPPSSSPGGPPPPPSSPPPPPGGPSSSPPGBBPPSSPPGPSSPG
GPSSPBPSSSSSPBBBBPSSSSPBBPSSSSSSSSSSPGGPSSSSPGBBGPSSPGBPSSPG
GPSSPBPPPSSSPGGGGPSSSPPGGPSSSSSSSSSSPGGPPSSSPGGGGPSSPGBPSSPG
GPSSPGGGPPSSPGGGGPSSPPGGGPSSPPPPPPSSPGGGPPSSPGGGGPSSPGBPSSPG
GPSSPGGBBPSSPGGGGPSSPGGGBPSSPGGGGPSSPGGGGPSSPGGGGPSSPGBPSSPG
GPSSPGGBBPSSPGGGGPSSPGBBBPSSPGGGGPSSPGGGGPSSPGGGGPSSPGBPSSPG
GPSSPGPPPPSSPPPPPPZZPPPPPPZZPPPPPPSSPPPPPPZZPPPPPPZZPPGPSSPG
GPSSPBPSSSSSSSSSSSSSSSSSSSSSSSSSSSSSSSSSSZSSZSSSSSSSSPBPSSPG
GPSSPBPSSSSSSSSSSSSSSSSSSSSSSSSSSSSSSSSSSZSSZSSSSSSSSPBPSSPG
GPSSPGPSSPPPPPSSPPPPPPPPPPPPZZPPPPPZZPPPPPSSPPPPPSSPPPBPSSPG
GPSSPBPSSPGGGPSSPGGGGGGGBBBPSSPGGGPSSPBBGPSSPGBBPSSPBGBPSSPG
GPSSPBPSSPGGGPSSPGGGGGGGBBBPSSPGGGPSSPBBGPSSPGBBPSSPBGBPSSPG
GPSSPGPSSPPPPPZZPPPPPPPPPPPPSSPPPPPSSPPPPPSSPPPPPSSPPGGPSSPG
GPSSPGPSSSSSSZSSZSSSSSSSSSSSSSSSSSSSSSSSSSSSSSSSSSSSPGBPSSPG
GPSSPGPSSSSSSZSSZSSSSSSSSSSSSSSSSSSSSSSSSSSSSSSSSSSSPGBPSSPG
GPSSPGPPSSPPPPZZPPPPSSPPPPZZPPPPSSPPPPPPPPPPSSPPPPZZPGBPSSPG
GPSSPGGPSSPBBPSSPBBPSSPGBPSSPBGPSSPGGGGGGGGPSSPGGPSSPGBPSSPG
GPSSPGGPSSPBBPSSPBBPSSPBBPSSPBGPSSPGGGGGGGGPSSPGGPSSPGBPSSPG
GPSSPGGPSSPPPPSSPPPPZZPPPPSSPPPPZZPPPPPPPPPPZZPPPPSSPGGPSSPG
GPSSPGGPSSSSSSSSSSSSSSSSSSSSSSSSSSSSSSSSSSSSSSSSSSPPPGGPSSPG
GPSSPGGPSSSSSSSSSSSSSSSSSSSSSSSSSSSSSSSSSSSSSSSSSSPGGGGPSSPG
GPSSPGGPPPPPPPPPPPPPPPPPPPPPPSSPPPPPPPPPPPPPPPPPPPPGGGGPSSPG
GPSSPGGGGGGGGGGGGGBBBBGGBBBBPSSPBBBBGGBBBBGGGGGGGGGGGGGPSSPG
PPSSPPPPPPPPPPPPPPPPPPPPPPPPPSSPPPPPPPPPPPPPPPPPPPPPPPPPSSPP
SSSSZSSSSSSSSSSSSSSSSSSSSSSSSSSSSSSSSSSSSSSSSSSSSSSSSSSZSSSS
SSSSZSSSSSSSSSSSSSSSSSSSSSSSSSSSSSSSSSSSSSSSSSSSSSSSSSSZSSSS
PPSSPPPPPPPPPPPPPPPPPPPPPPPPPPPPPPPPPPPPPPPPPPPPPPPPPPPPSSPP
GPSSPGGGGGGGGGGGGGGGGGGGGGGGGGGGGGGGGGGGGGGGGGGGGGGGGGGPSSPG